Date_reported,Country_code,Country,WHO_region,New_cases,Cumulative_cases,New_deaths,Cumulative_deaths
2020-03-23,AF,Afghanistan,EMRO,6,40,1,1
2020-03-24,AF,Afghanistan,EMRO,2,42,0,1
2020-03-25,AF,Afghanistan,EMRO,32,74,0,1
2020-03-26,AF,Afghanistan,EMRO,6,80,1,2
2020-03-27,AF,Afghanistan,EMRO,11,91,0,2
2020-03-28,AF,Afghanistan,EMRO,15,106,0,2
2020-03-29,AF,Afghanistan,EMRO,8,114,2,4
2020-03-30,AF,Afghanistan,EMRO,0,114,0,4
2020-03-31,AF,Afghanistan,EMRO,52,166,0,4
2020-04-01,AF,Afghanistan,EMRO,26,192,0,4
2020-04-02,AF,Afghanistan,EMRO,43,235,0,4
2020-04-03,AF,Afghanistan,EMRO,34,269,1,5
2020-04-04,AF,Afghanistan,EMRO,1,270,0,5
2020-04-05,AF,Afghanistan,EMRO,29,299,2,7
2020-04-06,AF,Afghanistan,EMRO,38,337,0,7
2020-04-07,AF,Afghanistan,EMRO,30,367,4,11
2020-04-08,AF,Afghanistan,EMRO,56,423,3,14
2020-04-09,AF,Afghanistan,EMRO,21,444,1,15
2020-04-10,AF,Afghanistan,EMRO,77,521,0,15
2020-04-11,AF,Afghanistan,EMRO,0,521,0,15
2020-04-12,AF,Afghanistan,EMRO,34,555,3,18
2020-04-13,AF,Afghanistan,EMRO,52,607,1,19
2020-04-14,AF,Afghanistan,EMRO,58,665,3,22
2020-04-15,AF,Afghanistan,EMRO,105,770,3,25
2020-04-16,AF,Afghanistan,EMRO,24,794,4,29
2020-04-17,AF,Afghanistan,EMRO,51,845,1,30
2020-04-18,AF,Afghanistan,EMRO,63,908,0,30
2020-04-19,AF,Afghanistan,EMRO,25,933,0,30
2020-04-20,AF,Afghanistan,EMRO,63,996,3,33
2020-04-21,AF,Afghanistan,EMRO,30,1026,3,36
2020-04-22,AF,Afghanistan,EMRO,66,1092,0,36
2020-04-23,AF,Afghanistan,EMRO,84,1176,4,40
2020-04-24,AF,Afghanistan,EMRO,50,1226,0,40
2020-04-25,AF,Afghanistan,EMRO,104,1330,3,43
2020-04-26,AF,Afghanistan,EMRO,133,1463,6,49
2020-04-27,AF,Afghanistan,EMRO,68,1531,1,50
2020-04-28,AF,Afghanistan,EMRO,172,1703,10,60
2020-04-29,AF,Afghanistan,EMRO,124,1827,0,60
2020-04-30,AF,Afghanistan,EMRO,0,1827,0,60
2020-05-01,AF,Afghanistan,EMRO,344,2171,4,64
2020-05-02,AF,Afghanistan,EMRO,298,2469,8,72
2020-05-03,AF,Afghanistan,EMRO,0,2469,0,72
2020-05-04,AF,Afghanistan,EMRO,0,2469,0,72
2020-05-05,AF,Afghanistan,EMRO,0,2469,0,72
2020-05-06,AF,Afghanistan,EMRO,755,3224,23,95
2020-05-07,AF,Afghanistan,EMRO,168,3392,9,104
2020-05-08,AF,Afghanistan,EMRO,171,3563,1,105
2020-05-09,AF,Afghanistan,EMRO,0,3563,0,105
2020-05-10,AF,Afghanistan,EMRO,839,4402,14,119
2020-05-11,AF,Afghanistan,EMRO,262,4664,1,120
2020-05-12,AF,Afghanistan,EMRO,303,4967,7,127
2020-05-13,AF,Afghanistan,EMRO,0,4967,0,127
2020-05-14,AF,Afghanistan,EMRO,372,5339,9,136
2020-05-15,AF,Afghanistan,EMRO,714,6053,17,153
2020-05-16,AF,Afghanistan,EMRO,349,6402,15,168
2020-05-17,AF,Afghanistan,EMRO,233,6635,1,169
2020-05-18,AF,Afghanistan,EMRO,437,7072,4,173
2020-05-19,AF,Afghanistan,EMRO,583,7655,4,177
2020-05-20,AF,Afghanistan,EMRO,490,8145,10,187
2020-05-21,AF,Afghanistan,EMRO,531,8676,6,193
2020-05-22,AF,Afghanistan,EMRO,540,9216,12,205
2020-05-23,AF,Afghanistan,EMRO,736,9952,10,215
2020-05-24,AF,Afghanistan,EMRO,716,10668,7,222
2020-05-25,AF,Afghanistan,EMRO,512,11180,1,223
2020-05-26,AF,Afghanistan,EMRO,737,11917,1,224
2020-05-27,AF,Afghanistan,EMRO,548,12465,6,230
2020-05-28,AF,Afghanistan,EMRO,637,13102,9,239
2020-05-29,AF,Afghanistan,EMRO,643,13745,11,250
2020-05-30,AF,Afghanistan,EMRO,784,14529,2,252
2020-05-31,AF,Afghanistan,EMRO,651,15180,2,254
2020-06-01,AF,Afghanistan,EMRO,656,15836,15,269
2020-06-02,AF,Afghanistan,EMRO,742,16578,5,274
2020-06-03,AF,Afghanistan,EMRO,775,17353,24,298
2020-06-04,AF,Afghanistan,EMRO,624,17977,5,303
2020-06-05,AF,Afghanistan,EMRO,1078,19055,10,313
2020-06-06,AF,Afghanistan,EMRO,582,19637,18,331
2020-06-07,AF,Afghanistan,EMRO,791,20428,30,361
2020-06-08,AF,Afghanistan,EMRO,575,21003,12,373
2020-06-09,AF,Afghanistan,EMRO,305,21308,7,380
2020-06-10,AF,Afghanistan,EMRO,920,22228,29,409
2020-06-11,AF,Afghanistan,EMRO,748,22976,21,430
2020-06-12,AF,Afghanistan,EMRO,656,23632,20,450
2020-06-13,AF,Afghanistan,EMRO,556,24188,5,455
2020-06-14,AF,Afghanistan,EMRO,664,24852,20,475
2020-06-15,AF,Afghanistan,EMRO,761,25613,5,480
2020-06-16,AF,Afghanistan,EMRO,106,25719,8,488
2020-06-17,AF,Afghanistan,EMRO,1241,26960,20,508
2020-06-18,AF,Afghanistan,EMRO,463,27423,42,550
2020-06-19,AF,Afghanistan,EMRO,541,27964,2,552
2020-06-20,AF,Afghanistan,EMRO,419,28383,0,552
2020-06-21,AF,Afghanistan,EMRO,536,28919,33,585
2020-06-22,AF,Afghanistan,EMRO,310,29229,17,602
2020-06-23,AF,Afghanistan,EMRO,338,29567,20,622
2020-06-24,AF,Afghanistan,EMRO,159,29726,21,643
2020-06-25,AF,Afghanistan,EMRO,535,30261,36,679
2020-06-26,AF,Afghanistan,EMRO,85,30346,5,684
2020-06-27,AF,Afghanistan,EMRO,356,30702,23,707
2020-06-28,AF,Afghanistan,EMRO,351,31053,26,733
2020-06-29,AF,Afghanistan,EMRO,271,31324,4,737
2020-06-30,AF,Afghanistan,EMRO,121,31445,2,739
2020-07-01,AF,Afghanistan,EMRO,403,31848,39,778
2020-07-02,AF,Afghanistan,EMRO,260,32108,33,811
2020-07-03,AF,Afghanistan,EMRO,302,32410,12,823
2020-07-04,AF,Afghanistan,EMRO,348,32758,7,830
2020-07-05,AF,Afghanistan,EMRO,279,33037,38,868
2020-07-06,AF,Afghanistan,EMRO,113,33150,23,891
2020-07-07,AF,Afghanistan,EMRO,320,33470,33,924
2020-07-08,AF,Afghanistan,EMRO,210,33680,16,940
2020-07-09,AF,Afghanistan,EMRO,59,33739,1,941
2020-07-10,AF,Afghanistan,EMRO,541,34280,34,975
2020-07-11,AF,Afghanistan,EMRO,157,34437,4,979
2020-07-12,AF,Afghanistan,EMRO,100,34537,35,1014
2020-07-13,AF,Afghanistan,EMRO,4,34541,2,1016
2020-07-14,AF,Afghanistan,EMRO,285,34826,33,1049
2020-07-15,AF,Afghanistan,EMRO,200,35026,49,1098
2020-07-16,AF,Afghanistan,EMRO,130,35156,19,1117
2020-07-17,AF,Afghanistan,EMRO,159,35315,34,1151
2020-07-18,AF,Afghanistan,EMRO,60,35375,0,1151
2020-07-19,AF,Afghanistan,EMRO,186,35561,34,1185
2020-07-20,AF,Afghanistan,EMRO,34,35595,2,1187
2020-07-21,AF,Afghanistan,EMRO,106,35701,1,1188
2020-07-22,AF,Afghanistan,EMRO,112,35813,6,1194
2020-07-23,AF,Afghanistan,EMRO,188,36001,21,1215
2020-07-24,AF,Afghanistan,EMRO,66,36067,14,1229
2020-07-25,AF,Afghanistan,EMRO,55,36122,21,1250
2020-07-26,AF,Afghanistan,EMRO,121,36243,13,1263
2020-07-27,AF,Afghanistan,EMRO,106,36349,10,1273
2020-07-28,AF,Afghanistan,EMRO,105,36454,1,1274
2020-07-29,AF,Afghanistan,EMRO,103,36557,1,1275
2020-07-30,AF,Afghanistan,EMRO,71,36628,0,1275
2020-07-31,AF,Afghanistan,EMRO,0,36628,0,1275
2020-08-01,AF,Afghanistan,EMRO,168,36796,12,1287
2020-08-02,AF,Afghanistan,EMRO,0,36796,0,1287
2020-08-03,AF,Afghanistan,EMRO,0,36796,0,1287
2020-08-04,AF,Afghanistan,EMRO,37,36833,5,1292
2020-08-05,AF,Afghanistan,EMRO,82,36915,6,1298
2020-08-06,AF,Afghanistan,EMRO,67,36982,4,1302
2020-08-07,AF,Afghanistan,EMRO,41,37023,0,1302
2020-08-08,AF,Afghanistan,EMRO,78,37101,9,1311
2020-08-09,AF,Afghanistan,EMRO,39,37140,5,1316
2020-08-10,AF,Afghanistan,EMRO,0,37140,0,1316
2020-08-11,AF,Afghanistan,EMRO,215,37355,32,1348
2020-08-12,AF,Afghanistan,EMRO,76,37431,10,1358
2020-08-13,AF,Afghanistan,EMRO,79,37510,9,1367
2020-08-14,AF,Afghanistan,EMRO,7,37517,0,1367
2020-08-15,AF,Afghanistan,EMRO,120,37637,7,1374
2020-08-16,AF,Afghanistan,EMRO,45,37682,5,1379
2020-08-17,AF,Afghanistan,EMRO,0,37682,0,1379
2020-08-18,AF,Afghanistan,EMRO,3,37685,0,1379
2020-08-19,AF,Afghanistan,EMRO,0,37685,0,1379
2020-08-20,AF,Afghanistan,EMRO,160,37845,8,1387
2020-08-21,AF,Afghanistan,EMRO,97,37942,2,1389
2020-08-22,AF,Afghanistan,EMRO,38,37980,0,1389
2020-08-23,AF,Afghanistan,EMRO,59,38039,0,1389
2020-08-24,AF,Afghanistan,EMRO,46,38085,2,1391
2020-08-25,AF,Afghanistan,EMRO,71,38156,10,1401
2020-08-26,AF,Afghanistan,EMRO,43,38199,4,1405
2020-08-27,AF,Afghanistan,EMRO,16,38215,0,1405
2020-08-28,AF,Afghanistan,EMRO,11,38226,1,1406
2020-08-29,AF,Afghanistan,EMRO,3,38229,0,1406
2020-08-30,AF,Afghanistan,EMRO,0,38229,0,1406
2020-08-31,AF,Afghanistan,EMRO,19,38248,0,1406
2020-09-01,AF,Afghanistan,EMRO,34,38282,4,1410
2020-09-02,AF,Afghanistan,EMRO,47,38329,3,1413
2020-09-03,AF,Afghanistan,EMRO,45,38374,0,1413
2020-09-04,AF,Afghanistan,EMRO,0,38374,0,1413
2020-09-05,AF,Afghanistan,EMRO,16,38390,0,1413
2020-09-06,AF,Afghanistan,EMRO,94,38484,3,1416
2020-09-07,AF,Afghanistan,EMRO,96,38580,3,1419
2020-09-08,AF,Afghanistan,EMRO,26,38606,3,1422
2020-09-09,AF,Afghanistan,EMRO,24,38630,2,1424
2020-09-10,AF,Afghanistan,EMRO,28,38658,0,1424
2020-09-11,AF,Afghanistan,EMRO,34,38692,0,1424
2020-09-12,AF,Afghanistan,EMRO,35,38727,0,1424
2020-09-13,AF,Afghanistan,EMRO,75,38802,0,1424
2020-09-14,AF,Afghanistan,EMRO,56,38858,5,1429
2020-09-15,AF,Afghanistan,EMRO,43,38901,1,1430
2020-09-16,AF,Afghanistan,EMRO,40,38941,10,1440
2020-09-17,AF,Afghanistan,EMRO,17,38958,0,1440
2020-09-18,AF,Afghanistan,EMRO,11,38969,1,1441
2020-09-19,AF,Afghanistan,EMRO,36,39005,0,1441
2020-09-20,AF,Afghanistan,EMRO,125,39130,4,1445
2020-09-21,AF,Afghanistan,EMRO,30,39160,3,1448
2020-09-22,AF,Afghanistan,EMRO,22,39182,1,1449
2020-09-23,AF,Afghanistan,EMRO,49,39231,1,1450
2020-09-24,AF,Afghanistan,EMRO,25,39256,5,1455
2020-09-25,AF,Afghanistan,EMRO,16,39272,0,1455
2020-09-26,AF,Afghanistan,EMRO,6,39278,2,1457
2020-09-27,AF,Afghanistan,EMRO,35,39313,0,1457
2020-09-28,AF,Afghanistan,EMRO,12,39325,3,1460
2020-09-29,AF,Afghanistan,EMRO,15,39340,2,1462
2020-09-30,AF,Afghanistan,EMRO,14,39354,0,1462
2020-10-01,AF,Afghanistan,EMRO,17,39371,0,1462
2020-10-02,AF,Afghanistan,EMRO,5,39376,0,1462
2020-10-03,AF,Afghanistan,EMRO,7,39383,4,1466
2020-10-04,AF,Afghanistan,EMRO,44,39427,0,1466
2020-10-05,AF,Afghanistan,EMRO,81,39508,4,1470
2020-10-06,AF,Afghanistan,EMRO,64,39572,1,1471
2020-10-07,AF,Afghanistan,EMRO,62,39634,2,1473
2020-10-08,AF,Afghanistan,EMRO,68,39702,1,1474
2020-10-09,AF,Afghanistan,EMRO,77,39779,2,1476
2020-10-10,AF,Afghanistan,EMRO,10,39789,1,1477
2020-10-11,AF,Afghanistan,EMRO,96,39885,4,1481
2020-10-12,AF,Afghanistan,EMRO,71,39956,2,1483
2020-10-13,AF,Afghanistan,EMRO,58,40014,1,1484
2020-10-14,AF,Afghanistan,EMRO,66,40080,1,1485
2020-10-15,AF,Afghanistan,EMRO,32,40112,0,1485
2020-10-16,AF,Afghanistan,EMRO,47,40159,4,1489
2020-10-17,AF,Afghanistan,EMRO,68,40227,3,1492
2020-10-18,AF,Afghanistan,EMRO,59,40286,4,1496
2020-10-19,AF,Afghanistan,EMRO,87,40373,5,1501
2020-10-20,AF,Afghanistan,EMRO,88,40461,2,1503
2020-10-21,AF,Afghanistan,EMRO,0,40461,0,1503
2020-10-22,AF,Afghanistan,EMRO,49,40510,0,1503
2020-10-23,AF,Afghanistan,EMRO,116,40626,2,1505
2020-10-24,AF,Afghanistan,EMRO,61,40687,2,1507
2020-10-25,AF,Afghanistan,EMRO,81,40768,4,1511
2020-10-26,AF,Afghanistan,EMRO,65,40833,3,1514
2020-10-27,AF,Afghanistan,EMRO,104,40937,4,1518
2020-10-28,AF,Afghanistan,EMRO,95,41032,5,1523
2020-10-29,AF,Afghanistan,EMRO,113,41145,6,1529
2020-10-30,AF,Afghanistan,EMRO,123,41268,3,1532
2020-10-31,AF,Afghanistan,EMRO,66,41334,1,1533
2020-11-01,AF,Afghanistan,EMRO,91,41425,3,1536
2020-11-02,AF,Afghanistan,EMRO,76,41501,0,1536
2020-11-03,AF,Afghanistan,EMRO,132,41633,5,1541
2020-11-04,AF,Afghanistan,EMRO,95,41728,3,1544
2020-11-05,AF,Afghanistan,EMRO,86,41814,4,1548
2020-11-06,AF,Afghanistan,EMRO,121,41935,6,1554
2020-11-07,AF,Afghanistan,EMRO,40,41975,0,1554
2020-11-08,AF,Afghanistan,EMRO,58,42033,2,1556
2020-11-09,AF,Afghanistan,EMRO,126,42159,6,1562
2020-11-10,AF,Afghanistan,EMRO,138,42297,12,1574
2020-11-11,AF,Afghanistan,EMRO,166,42463,3,1577
2020-11-12,AF,Afghanistan,EMRO,146,42609,4,1581
2020-11-13,AF,Afghanistan,EMRO,186,42795,10,1591
2020-11-14,AF,Afghanistan,EMRO,174,42969,4,1595
2020-11-15,AF,Afghanistan,EMRO,66,43035,10,1605
2020-11-16,AF,Afghanistan,EMRO,205,43240,12,1617
2020-11-17,AF,Afghanistan,EMRO,163,43403,9,1626
2020-11-18,AF,Afghanistan,EMRO,225,43628,12,1638
2020-11-19,AF,Afghanistan,EMRO,223,43851,7,1645
2020-11-20,AF,Afghanistan,EMRO,377,44228,5,1650
2020-11-21,AF,Afghanistan,EMRO,215,44443,11,1661
2020-11-22,AF,Afghanistan,EMRO,60,44503,14,1675
2020-11-23,AF,Afghanistan,EMRO,203,44706,12,1687
2020-11-24,AF,Afghanistan,EMRO,282,44988,8,1695
2020-11-25,AF,Afghanistan,EMRO,290,45278,17,1712
2020-11-26,AF,Afghanistan,EMRO,212,45490,13,1725
2020-11-27,AF,Afghanistan,EMRO,226,45716,12,1737
2020-11-28,AF,Afghanistan,EMRO,123,45839,3,1740
2020-11-29,AF,Afghanistan,EMRO,127,45966,12,1752
2020-11-30,AF,Afghanistan,EMRO,249,46215,11,1763
2020-12-01,AF,Afghanistan,EMRO,283,46498,11,1774
2020-12-02,AF,Afghanistan,EMRO,219,46717,21,1795
2020-12-03,AF,Afghanistan,EMRO,263,46980,27,1822
2020-12-04,AF,Afghanistan,EMRO,278,47258,19,1841
2020-12-05,AF,Afghanistan,EMRO,130,47388,6,1847
2020-12-06,AF,Afghanistan,EMRO,253,47641,18,1865
2020-12-07,AF,Afghanistan,EMRO,260,47901,10,1875
2020-12-08,AF,Afghanistan,EMRO,235,48136,27,1902
2020-12-09,AF,Afghanistan,EMRO,230,48366,6,1908
2020-12-10,AF,Afghanistan,EMRO,174,48540,13,1921
2020-12-11,AF,Afghanistan,EMRO,213,48753,18,1939
2020-12-12,AF,Afghanistan,EMRO,73,48826,10,1949
2020-12-13,AF,Afghanistan,EMRO,126,48952,11,1960
2020-12-14,AF,Afghanistan,EMRO,321,49273,11,1971
2020-12-15,AF,Afghanistan,EMRO,211,49484,4,1975
2020-12-16,AF,Afghanistan,EMRO,219,49703,26,2001
2020-12-17,AF,Afghanistan,EMRO,224,49927,16,2017
2020-12-18,AF,Afghanistan,EMRO,275,50202,15,2032
2020-12-19,AF,Afghanistan,EMRO,254,50456,5,2037
2020-12-20,AF,Afghanistan,EMRO,80,50536,17,2054
2020-12-21,AF,Afghanistan,EMRO,142,50678,20,2074
2020-12-22,AF,Afghanistan,EMRO,210,50888,15,2089
2020-12-23,AF,Afghanistan,EMRO,182,51070,16,2105
2020-12-24,AF,Afghanistan,EMRO,287,51357,21,2126
2020-12-25,AF,Afghanistan,EMRO,238,51595,9,2135
2020-12-26,AF,Afghanistan,EMRO,169,51764,13,2148
2020-12-27,AF,Afghanistan,EMRO,84,51848,10,2158
2020-12-28,AF,Afghanistan,EMRO,159,52007,12,2170
2020-12-29,AF,Afghanistan,EMRO,140,52147,12,2182
2020-12-30,AF,Afghanistan,EMRO,183,52330,7,2189
2020-12-31,AF,Afghanistan,EMRO,0,52330,0,2189
2021-01-01,AF,Afghanistan,EMRO,183,52513,12,2201
2021-01-02,AF,Afghanistan,EMRO,73,52586,10,2211
2021-01-03,AF,Afghanistan,EMRO,123,52709,10,2221
2021-01-04,AF,Afghanistan,EMRO,200,52909,9,2230
2021-01-05,AF,Afghanistan,EMRO,102,53011,7,2237
2021-01-06,AF,Afghanistan,EMRO,94,53105,7,2244
2021-01-07,AF,Afghanistan,EMRO,102,53207,9,2253
2021-01-08,AF,Afghanistan,EMRO,125,53332,4,2257
2021-01-09,AF,Afghanistan,EMRO,68,53400,7,2264
2021-01-10,AF,Afghanistan,EMRO,89,53489,13,2277
2021-01-11,AF,Afghanistan,EMRO,49,53538,11,2288
2021-01-12,AF,Afghanistan,EMRO,46,53584,13,2301
2021-01-13,AF,Afghanistan,EMRO,106,53690,7,2308
2021-01-14,AF,Afghanistan,EMRO,85,53775,6,2314
2021-01-15,AF,Afghanistan,EMRO,56,53831,10,2324
2021-01-16,AF,Afghanistan,EMRO,107,53938,12,2336
2021-01-17,AF,Afghanistan,EMRO,46,53984,3,2339
2021-01-18,AF,Afghanistan,EMRO,78,54062,4,2343
2021-01-19,AF,Afghanistan,EMRO,79,54141,3,2346
2021-01-20,AF,Afghanistan,EMRO,137,54278,8,2354
2021-01-21,AF,Afghanistan,EMRO,125,54403,9,2363
2021-01-22,AF,Afghanistan,EMRO,80,54483,7,2370
2021-01-23,AF,Afghanistan,EMRO,76,54559,3,2373
2021-01-24,AF,Afghanistan,EMRO,36,54595,5,2378
2021-01-25,AF,Afghanistan,EMRO,77,54672,7,2385
2021-01-26,AF,Afghanistan,EMRO,78,54750,4,2389
2021-01-27,AF,Afghanistan,EMRO,104,54854,0,2389
2021-01-28,AF,Afghanistan,EMRO,37,54891,8,2397
2021-01-29,AF,Afghanistan,EMRO,48,54939,2,2399
2021-01-30,AF,Afghanistan,EMRO,69,55008,1,2400
2021-01-31,AF,Afghanistan,EMRO,15,55023,0,2400
2021-02-01,AF,Afghanistan,EMRO,36,55059,4,2404
2021-02-02,AF,Afghanistan,EMRO,62,55121,1,2405
2021-02-03,AF,Afghanistan,EMRO,53,55174,1,2406
2021-02-04,AF,Afghanistan,EMRO,57,55231,1,2407
2021-02-05,AF,Afghanistan,EMRO,34,55265,0,2407
2021-02-06,AF,Afghanistan,EMRO,65,55330,1,2408
2021-02-07,AF,Afghanistan,EMRO,5,55335,2,2410
2021-02-08,AF,Afghanistan,EMRO,24,55359,3,2413
2021-02-09,AF,Afghanistan,EMRO,25,55384,1,2414
2021-02-10,AF,Afghanistan,EMRO,18,55402,4,2418
2021-02-11,AF,Afghanistan,EMRO,18,55420,1,2419
2021-02-12,AF,Afghanistan,EMRO,25,55445,5,2424
2021-02-13,AF,Afghanistan,EMRO,28,55473,3,2427
2021-02-14,AF,Afghanistan,EMRO,19,55492,0,2427
2021-02-15,AF,Afghanistan,EMRO,22,55514,0,2427
2021-02-16,AF,Afghanistan,EMRO,4,55518,1,2428
2021-02-17,AF,Afghanistan,EMRO,22,55540,0,2428
2021-02-18,AF,Afghanistan,EMRO,17,55557,2,2430
2021-02-19,AF,Afghanistan,EMRO,18,55575,0,2430
2021-02-20,AF,Afghanistan,EMRO,5,55580,0,2430
2021-02-21,AF,Afghanistan,EMRO,24,55604,2,2432
2021-02-22,AF,Afghanistan,EMRO,13,55617,1,2433
2021-02-23,AF,Afghanistan,EMRO,29,55646,2,2435
2021-02-24,AF,Afghanistan,EMRO,18,55664,1,2436
2021-02-25,AF,Afghanistan,EMRO,16,55680,2,2438
2021-02-26,AF,Afghanistan,EMRO,16,55696,4,2442
2021-02-27,AF,Afghanistan,EMRO,11,55707,1,2443
2021-02-28,AF,Afghanistan,EMRO,7,55714,0,2443
2021-03-01,AF,Afghanistan,EMRO,19,55733,1,2444
2021-03-02,AF,Afghanistan,EMRO,26,55759,2,2446
2021-03-03,AF,Afghanistan,EMRO,11,55770,0,2446
2021-03-04,AF,Afghanistan,EMRO,5,55775,0,2446
2021-03-05,AF,Afghanistan,EMRO,52,55827,3,2449
2021-03-06,AF,Afghanistan,EMRO,13,55840,0,2449
2021-03-07,AF,Afghanistan,EMRO,7,55847,0,2449
2021-03-08,AF,Afghanistan,EMRO,29,55876,2,2451
2021-03-09,AF,Afghanistan,EMRO,0,55876,0,2451
2021-03-10,AF,Afghanistan,EMRO,18,55894,0,2451
2021-03-11,AF,Afghanistan,EMRO,23,55917,0,2451
2021-03-12,AF,Afghanistan,EMRO,42,55959,3,2454
2021-03-13,AF,Afghanistan,EMRO,0,55959,0,2454
2021-03-14,AF,Afghanistan,EMRO,26,55985,3,2457
2021-03-15,AF,Afghanistan,EMRO,0,55985,2,2459
2021-03-16,AF,Afghanistan,EMRO,10,55995,1,2460
2021-03-17,AF,Afghanistan,EMRO,21,56016,0,2460
2021-03-18,AF,Afghanistan,EMRO,28,56044,2,2462
2021-03-19,AF,Afghanistan,EMRO,25,56069,0,2462
2021-03-20,AF,Afghanistan,EMRO,24,56093,0,2462
2021-03-21,AF,Afghanistan,EMRO,10,56103,1,2463
2021-03-22,AF,Afghanistan,EMRO,50,56153,1,2464
2021-03-23,AF,Afghanistan,EMRO,24,56177,2,2466
2021-03-24,AF,Afghanistan,EMRO,15,56192,0,2466
2021-03-25,AF,Afghanistan,EMRO,34,56226,1,2467
2021-03-26,AF,Afghanistan,EMRO,28,56254,0,2467
2021-03-27,AF,Afghanistan,EMRO,36,56290,2,2469
2021-03-28,AF,Afghanistan,EMRO,4,56294,1,2470
2021-03-29,AF,Afghanistan,EMRO,28,56322,2,2472
2021-03-30,AF,Afghanistan,EMRO,62,56384,4,2476
2021-03-31,AF,Afghanistan,EMRO,70,56454,8,2484
2021-04-01,AF,Afghanistan,EMRO,63,56517,5,2489
2021-04-02,AF,Afghanistan,EMRO,55,56572,6,2495
2021-04-03,AF,Afghanistan,EMRO,23,56595,1,2496
2021-04-04,AF,Afghanistan,EMRO,81,56676,1,2497
2021-04-05,AF,Afghanistan,EMRO,41,56717,11,2508
2021-04-06,AF,Afghanistan,EMRO,62,56779,4,2512
2021-04-07,AF,Afghanistan,EMRO,94,56873,0,2512
2021-04-08,AF,Afghanistan,EMRO,70,56943,4,2516
2021-04-09,AF,Afghanistan,EMRO,76,57019,5,2521
2021-04-10,AF,Afghanistan,EMRO,125,57144,0,2521
2021-04-11,AF,Afghanistan,EMRO,16,57160,0,2521
2021-04-12,AF,Afghanistan,EMRO,82,57242,8,2529
2021-04-13,AF,Afghanistan,EMRO,122,57364,0,2529
2021-04-14,AF,Afghanistan,EMRO,128,57492,3,2532
2021-04-15,AF,Afghanistan,EMRO,42,57534,1,2533
2021-04-16,AF,Afghanistan,EMRO,78,57612,2,2535
2021-04-17,AF,Afghanistan,EMRO,109,57721,4,2539
2021-04-18,AF,Afghanistan,EMRO,72,57793,0,2539
2021-04-19,AF,Afghanistan,EMRO,105,57898,7,2546
2021-04-20,AF,Afghanistan,EMRO,139,58037,3,2549
2021-04-21,AF,Afghanistan,EMRO,177,58214,8,2557
2021-04-22,AF,Afghanistan,EMRO,98,58312,4,2561
2021-04-23,AF,Afghanistan,EMRO,230,58542,4,2565
2021-04-24,AF,Afghanistan,EMRO,188,58730,7,2572
2021-04-25,AF,Afghanistan,EMRO,113,58843,10,2582
2021-04-26,AF,Afghanistan,EMRO,172,59015,10,2592
2021-04-27,AF,Afghanistan,EMRO,210,59225,6,2598
2021-04-28,AF,Afghanistan,EMRO,145,59370,13,2611
2021-04-29,AF,Afghanistan,EMRO,206,59576,7,2618
2021-04-30,AF,Afghanistan,EMRO,169,59745,7,2625
2021-05-01,AF,Afghanistan,EMRO,194,59939,6,2631
2021-05-02,AF,Afghanistan,EMRO,183,60122,6,2637
2021-05-03,AF,Afghanistan,EMRO,178,60300,5,2642
2021-05-04,AF,Afghanistan,EMRO,263,60563,6,2648
2021-05-05,AF,Afghanistan,EMRO,234,60797,6,2654
2021-05-06,AF,Afghanistan,EMRO,365,61162,10,2664
2021-05-07,AF,Afghanistan,EMRO,293,61455,9,2673
2021-05-08,AF,Afghanistan,EMRO,300,61755,10,2683
2021-05-09,AF,Afghanistan,EMRO,87,61842,3,2686
2021-05-10,AF,Afghanistan,EMRO,221,62063,12,2698
2021-05-11,AF,Afghanistan,EMRO,340,62403,12,2710
2021-05-12,AF,Afghanistan,EMRO,315,62718,3,2713
2021-05-13,AF,Afghanistan,EMRO,327,63045,8,2721
2021-05-14,AF,Afghanistan,EMRO,310,63355,9,2730
2021-05-15,AF,Afghanistan,EMRO,57,63412,3,2733
2021-05-16,AF,Afghanistan,EMRO,72,63484,9,2742
2021-05-17,AF,Afghanistan,EMRO,114,63598,3,2745
2021-05-18,AF,Afghanistan,EMRO,221,63819,6,2751
2021-05-19,AF,Afghanistan,EMRO,303,64122,11,2762
2021-05-20,AF,Afghanistan,EMRO,453,64575,10,2772
2021-05-21,AF,Afghanistan,EMRO,505,65080,10,2782
2021-05-22,AF,Afghanistan,EMRO,406,65486,10,2792
2021-05-23,AF,Afghanistan,EMRO,242,65728,10,2802
2021-05-24,AF,Afghanistan,EMRO,547,66275,10,2812
2021-05-25,AF,Afghanistan,EMRO,628,66903,24,2836
2021-05-26,AF,Afghanistan,EMRO,840,67743,19,2855
2021-05-27,AF,Afghanistan,EMRO,623,68366,14,2869
2021-05-28,AF,Afghanistan,EMRO,764,69130,12,2881
2021-05-29,AF,Afghanistan,EMRO,981,70111,18,2899
2021-05-30,AF,Afghanistan,EMRO,650,70761,20,2919
2021-05-31,AF,Afghanistan,EMRO,1077,71838,25,2944
2021-06-01,AF,Afghanistan,EMRO,1139,72977,29,2973
2021-06-02,AF,Afghanistan,EMRO,1049,74026,34,3007
2021-06-03,AF,Afghanistan,EMRO,1093,75119,27,3034
2021-06-04,AF,Afghanistan,EMRO,1509,76628,34,3068
2021-06-05,AF,Afghanistan,EMRO,1335,77963,36,3104
2021-06-06,AF,Afghanistan,EMRO,1261,79224,41,3145
2021-06-07,AF,Afghanistan,EMRO,1617,80841,42,3187
2021-06-08,AF,Afghanistan,EMRO,1485,82326,64,3251
2021-06-09,AF,Afghanistan,EMRO,1724,84050,54,3305
2021-06-10,AF,Afghanistan,EMRO,1842,85892,51,3356
2021-06-11,AF,Afghanistan,EMRO,1824,87716,56,3412
2021-06-12,AF,Afghanistan,EMRO,1024,88740,37,3449
2021-06-13,AF,Afghanistan,EMRO,1121,89861,78,3527
2021-06-14,AF,Afghanistan,EMRO,1597,91458,85,3612
2021-06-15,AF,Afghanistan,EMRO,1814,93272,71,3683
2021-06-16,AF,Afghanistan,EMRO,16,93288,0,3683
2021-06-17,AF,Afghanistan,EMRO,3243,96531,159,3842
2021-06-18,AF,Afghanistan,EMRO,2203,98734,92,3934
2021-06-19,AF,Afghanistan,EMRO,1787,100521,96,4030
2021-06-20,AF,Afghanistan,EMRO,1385,101906,92,4122
2021-06-21,AF,Afghanistan,EMRO,1996,103902,93,4215
2021-06-22,AF,Afghanistan,EMRO,1847,105749,78,4293
2021-06-23,AF,Afghanistan,EMRO,2208,107957,73,4366
2021-06-24,AF,Afghanistan,EMRO,1575,109532,86,4452
2021-06-25,AF,Afghanistan,EMRO,2060,111592,67,4519
2021-06-26,AF,Afghanistan,EMRO,1532,113124,75,4594
2021-06-27,AF,Afghanistan,EMRO,1096,114220,56,4650
2021-06-28,AF,Afghanistan,EMRO,1531,115751,80,4730
2021-06-29,AF,Afghanistan,EMRO,1407,117158,64,4794
2021-06-30,AF,Afghanistan,EMRO,1501,118659,77,4871
2021-07-01,AF,Afghanistan,EMRO,1557,120216,91,4962
2021-07-02,AF,Afghanistan,EMRO,1940,122156,86,5048
2021-07-03,AF,Afghanistan,EMRO,1329,123485,59,5107
2021-07-04,AF,Afghanistan,EMRO,1263,124748,92,5199
2021-07-05,AF,Afghanistan,EMRO,1189,125937,84,5283
2021-07-06,AF,Afghanistan,EMRO,1527,127464,77,5360
2021-07-07,AF,Afghanistan,EMRO,1557,129021,55,5415
2021-07-08,AF,Afghanistan,EMRO,1092,130113,62,5477
2021-07-09,AF,Afghanistan,EMRO,1473,131586,84,5561
2021-07-10,AF,Afghanistan,EMRO,1191,132777,77,5638
2021-07-11,AF,Afghanistan,EMRO,801,133578,86,5724
2021-07-12,AF,Afghanistan,EMRO,1075,134653,67,5791
2021-07-13,AF,Afghanistan,EMRO,1236,135889,58,5849
2021-07-14,AF,Afghanistan,EMRO,754,136643,74,5923
2021-07-15,AF,Afghanistan,EMRO,1210,137853,60,5983
2021-07-16,AF,Afghanistan,EMRO,1198,139051,89,6072
2021-07-17,AF,Afghanistan,EMRO,1173,140224,26,6098
2021-07-18,AF,Afghanistan,EMRO,378,140602,49,6147
2021-07-19,AF,Afghanistan,EMRO,897,141499,66,6213
2021-07-20,AF,Afghanistan,EMRO,915,142414,53,6266
2021-07-21,AF,Afghanistan,EMRO,348,142762,27,6293
2021-07-22,AF,Afghanistan,EMRO,421,143183,32,6325
2021-07-23,AF,Afghanistan,EMRO,256,143439,32,6357
2021-07-24,AF,Afghanistan,EMRO,227,143666,36,6393
2021-07-25,AF,Afghanistan,EMRO,205,143871,32,6425
2021-07-26,AF,Afghanistan,EMRO,414,144285,52,6477
2021-07-27,AF,Afghanistan,EMRO,723,145008,38,6515
2021-07-28,AF,Afghanistan,EMRO,544,145552,62,6577
2021-07-29,AF,Afghanistan,EMRO,444,145996,38,6615
2021-07-30,AF,Afghanistan,EMRO,527,146523,62,6677
2021-07-31,AF,Afghanistan,EMRO,631,147154,31,6708
2021-08-01,AF,Afghanistan,EMRO,347,147501,29,6737
2021-08-02,AF,Afghanistan,EMRO,484,147985,37,6774
2021-08-03,AF,Afghanistan,EMRO,587,148572,30,6804
2021-08-04,AF,Afghanistan,EMRO,361,148933,32,6836
2021-08-05,AF,Afghanistan,EMRO,428,149361,28,6864
2021-08-06,AF,Afghanistan,EMRO,449,149810,15,6879
2021-08-07,AF,Afghanistan,EMRO,430,150240,18,6897
2021-08-08,AF,Afghanistan,EMRO,218,150458,11,6908
2021-08-09,AF,Afghanistan,EMRO,320,150778,28,6936
2021-08-10,AF,Afghanistan,EMRO,235,151013,25,6961
2021-08-11,AF,Afghanistan,EMRO,278,151291,17,6978
2021-08-12,AF,Afghanistan,EMRO,272,151563,10,6988
2021-08-13,AF,Afghanistan,EMRO,207,151770,12,7000
2021-08-14,AF,Afghanistan,EMRO,171,151941,10,7010
2021-08-15,AF,Afghanistan,EMRO,92,152033,11,7021
2021-08-16,AF,Afghanistan,EMRO,109,152142,4,7025
2021-08-17,AF,Afghanistan,EMRO,101,152243,6,7031
2021-08-18,AF,Afghanistan,EMRO,120,152363,12,7043
2021-08-19,AF,Afghanistan,EMRO,48,152411,4,7047
2021-08-20,AF,Afghanistan,EMRO,37,152448,7,7054
2021-08-21,AF,Afghanistan,EMRO,49,152497,11,7065
2021-08-22,AF,Afghanistan,EMRO,14,152511,5,7070
2021-08-23,AF,Afghanistan,EMRO,72,152583,6,7076
2021-08-24,AF,Afghanistan,EMRO,77,152660,7,7083
2021-08-25,AF,Afghanistan,EMRO,62,152722,7,7090
2021-08-26,AF,Afghanistan,EMRO,100,152822,3,7093
2021-08-27,AF,Afghanistan,EMRO,138,152960,8,7101
2021-08-28,AF,Afghanistan,EMRO,47,153007,2,7103
2021-08-29,AF,Afghanistan,EMRO,26,153033,6,7109
2021-08-30,AF,Afghanistan,EMRO,115,153148,7,7116
2021-08-31,AF,Afghanistan,EMRO,72,153220,2,7118
2021-09-01,AF,Afghanistan,EMRO,40,153260,5,7123
2021-09-02,AF,Afghanistan,EMRO,46,153306,4,7127
2021-09-03,AF,Afghanistan,EMRO,69,153375,0,7127
2021-09-04,AF,Afghanistan,EMRO,20,153395,1,7128
2021-09-05,AF,Afghanistan,EMRO,28,153423,4,7132
2021-09-06,AF,Afghanistan,EMRO,111,153534,9,7141
2021-09-07,AF,Afghanistan,EMRO,92,153626,3,7144
2021-09-08,AF,Afghanistan,EMRO,110,153736,7,7151
2021-09-09,AF,Afghanistan,EMRO,104,153840,6,7157
2021-09-10,AF,Afghanistan,EMRO,122,153962,7,7164
2021-09-11,AF,Afghanistan,EMRO,20,153982,3,7167
2021-09-12,AF,Afghanistan,EMRO,8,153990,0,7167
2021-09-13,AF,Afghanistan,EMRO,104,154094,2,7169
2021-09-14,AF,Afghanistan,EMRO,86,154180,2,7171
2021-09-15,AF,Afghanistan,EMRO,103,154283,3,7174
2021-09-16,AF,Afghanistan,EMRO,78,154361,9,7183
2021-09-17,AF,Afghanistan,EMRO,126,154487,3,7186
2021-09-18,AF,Afghanistan,EMRO,45,154532,9,7195
2021-09-19,AF,Afghanistan,EMRO,7,154539,4,7199
2021-09-20,AF,Afghanistan,EMRO,46,154585,0,7199
2021-09-21,AF,Afghanistan,EMRO,127,154712,0,7199
2021-09-22,AF,Afghanistan,EMRO,45,154757,0,7199
2021-09-23,AF,Afghanistan,EMRO,43,154800,0,7199
2021-09-24,AF,Afghanistan,EMRO,38,154838,0,7199
2021-09-25,AF,Afghanistan,EMRO,59,154897,0,7199
2021-09-26,AF,Afghanistan,EMRO,2,154899,0,7199
2021-09-27,AF,Afghanistan,EMRO,51,154950,1,7200
2021-09-28,AF,Afghanistan,EMRO,21,154971,1,7201
2021-09-29,AF,Afghanistan,EMRO,35,155006,3,7204
2021-09-30,AF,Afghanistan,EMRO,46,155052,0,7204
2021-10-01,AF,Afghanistan,EMRO,17,155069,2,7206
2021-10-02,AF,Afghanistan,EMRO,37,155106,3,7209
2021-10-03,AF,Afghanistan,EMRO,35,155141,3,7212
2021-10-04,AF,Afghanistan,EMRO,24,155165,0,7212
2021-10-05,AF,Afghanistan,EMRO,22,155187,2,7214
2021-10-06,AF,Afghanistan,EMRO,31,155218,2,7216
2021-10-07,AF,Afghanistan,EMRO,42,155260,4,7220
2021-10-08,AF,Afghanistan,EMRO,47,155307,1,7221
2021-10-09,AF,Afghanistan,EMRO,19,155326,0,7221
2021-10-10,AF,Afghanistan,EMRO,18,155344,0,7221
2021-10-11,AF,Afghanistan,EMRO,43,155387,5,7226
2021-10-12,AF,Afghanistan,EMRO,31,155418,2,7228
2021-10-13,AF,Afghanistan,EMRO,59,155477,2,7230
2021-10-14,AF,Afghanistan,EMRO,28,155505,4,7234
2021-10-15,AF,Afghanistan,EMRO,55,155560,4,7238
2021-10-16,AF,Afghanistan,EMRO,21,155581,0,7238
2021-10-17,AF,Afghanistan,EMRO,36,155617,0,7238
2021-10-18,AF,Afghanistan,EMRO,24,155641,5,7243
2021-10-19,AF,Afghanistan,EMRO,13,155654,3,7246
2021-10-20,AF,Afghanistan,EMRO,25,155679,1,7247
2021-10-21,AF,Afghanistan,EMRO,58,155737,0,7247
2021-10-22,AF,Afghanistan,EMRO,32,155769,2,7249
2021-10-23,AF,Afghanistan,EMRO,40,155809,3,7252
2021-10-24,AF,Afghanistan,EMRO,9,155818,1,7253
2021-10-25,AF,Afghanistan,EMRO,45,155863,4,7257
2021-10-26,AF,Afghanistan,EMRO,55,155918,3,7260
2021-10-27,AF,Afghanistan,EMRO,31,155949,2,7262
2021-10-28,AF,Afghanistan,EMRO,53,156002,4,7266
2021-10-29,AF,Afghanistan,EMRO,42,156044,2,7268
2021-10-30,AF,Afghanistan,EMRO,30,156074,1,7269
2021-10-31,AF,Afghanistan,EMRO,14,156088,3,7272
2021-11-01,AF,Afghanistan,EMRO,40,156128,8,7280
2021-11-02,AF,Afghanistan,EMRO,34,156162,1,7281
2021-11-03,AF,Afghanistan,EMRO,23,156185,0,7281
2021-11-04,AF,Afghanistan,EMRO,16,156201,3,7284
2021-11-05,AF,Afghanistan,EMRO,40,156241,0,7284
2021-11-06,AF,Afghanistan,EMRO,29,156270,0,7284
2021-11-07,AF,Afghanistan,EMRO,5,156275,0,7284
2021-11-08,AF,Afghanistan,EMRO,20,156295,3,7287
2021-11-09,AF,Afghanistan,EMRO,34,156329,1,7288
2021-11-10,AF,Afghanistan,EMRO,36,156365,2,7290
2021-11-11,AF,Afghanistan,EMRO,49,156414,1,7291
2021-11-12,AF,Afghanistan,EMRO,42,156456,1,7292
2021-11-13,AF,Afghanistan,EMRO,35,156491,0,7292
2021-11-14,AF,Afghanistan,EMRO,21,156512,0,7292
2021-11-15,AF,Afghanistan,EMRO,40,156552,1,7293
2021-11-16,AF,Afghanistan,EMRO,58,156610,1,7294
2021-11-17,AF,Afghanistan,EMRO,39,156649,1,7295
2021-11-18,AF,Afghanistan,EMRO,90,156739,2,7297
2021-11-19,AF,Afghanistan,EMRO,47,156786,2,7299
2021-11-20,AF,Afghanistan,EMRO,44,156830,0,7299
2021-11-21,AF,Afghanistan,EMRO,34,156864,2,7301
2021-11-22,AF,Afghanistan,EMRO,47,156911,2,7303
2021-11-23,AF,Afghanistan,EMRO,50,156961,0,7303
2021-11-24,AF,Afghanistan,EMRO,54,157015,2,7305
2021-11-25,AF,Afghanistan,EMRO,17,157032,1,7306
2021-11-26,AF,Afghanistan,EMRO,112,157144,1,7307
2021-11-27,AF,Afghanistan,EMRO,27,157171,0,7307
2021-11-28,AF,Afghanistan,EMRO,19,157190,1,7308
2021-11-29,AF,Afghanistan,EMRO,28,157218,0,7308
2021-11-30,AF,Afghanistan,EMRO,42,157260,0,7308
2021-12-01,AF,Afghanistan,EMRO,29,157289,0,7308
2021-12-02,AF,Afghanistan,EMRO,70,157359,1,7309
2021-12-03,AF,Afghanistan,EMRO,28,157387,1,7310
2021-12-04,AF,Afghanistan,EMRO,20,157407,0,7310
2021-12-05,AF,Afghanistan,EMRO,24,157431,2,7312
2021-12-06,AF,Afghanistan,EMRO,23,157454,0,7312
2021-12-07,AF,Afghanistan,EMRO,45,157499,4,7316
2021-12-08,AF,Afghanistan,EMRO,9,157508,1,7317
2021-12-09,AF,Afghanistan,EMRO,34,157542,2,7319
2021-12-10,AF,Afghanistan,EMRO,43,157585,2,7321
2021-12-11,AF,Afghanistan,EMRO,18,157603,3,7324
2021-12-12,AF,Afghanistan,EMRO,8,157611,1,7325
2021-12-13,AF,Afghanistan,EMRO,22,157633,3,7328
2021-12-14,AF,Afghanistan,EMRO,15,157648,0,7328
2021-12-15,AF,Afghanistan,EMRO,12,157660,1,7329
2021-12-16,AF,Afghanistan,EMRO,5,157665,2,7331
2021-12-17,AF,Afghanistan,EMRO,60,157725,1,7332
2021-12-18,AF,Afghanistan,EMRO,9,157734,0,7332
2021-12-19,AF,Afghanistan,EMRO,11,157745,1,7333
2021-12-20,AF,Afghanistan,EMRO,42,157787,2,7335
2021-12-21,AF,Afghanistan,EMRO,10,157797,0,7335
2021-12-22,AF,Afghanistan,EMRO,19,157816,0,7335
2021-12-23,AF,Afghanistan,EMRO,25,157841,6,7341
2021-12-24,AF,Afghanistan,EMRO,37,157878,5,7346
2021-12-25,AF,Afghanistan,EMRO,9,157887,2,7348
2021-12-26,AF,Afghanistan,EMRO,15,157902,4,7352
2021-12-27,AF,Afghanistan,EMRO,49,157951,2,7354
2021-12-28,AF,Afghanistan,EMRO,16,157967,0,7354
2021-12-29,AF,Afghanistan,EMRO,31,157998,1,7355
2021-12-30,AF,Afghanistan,EMRO,41,158039,1,7356
2021-12-31,AF,Afghanistan,EMRO,20,158059,0,7356
2022-01-01,AF,Afghanistan,EMRO,0,158059,0,7356
2022-01-02,AF,Afghanistan,EMRO,53,158112,0,7356
2022-01-03,AF,Afghanistan,EMRO,44,158156,5,7361
2022-01-04,AF,Afghanistan,EMRO,15,158171,3,7364
2022-01-05,AF,Afghanistan,EMRO,36,158207,2,7366
2022-01-06,AF,Afghanistan,EMRO,38,158245,1,7367
2022-01-07,AF,Afghanistan,EMRO,34,158279,1,7368
2022-01-08,AF,Afghanistan,EMRO,26,158305,0,7368
2022-01-09,AF,Afghanistan,EMRO,40,158345,1,7369
2022-01-10,AF,Afghanistan,EMRO,36,158381,4,7373
2022-01-11,AF,Afghanistan,EMRO,13,158394,0,7373
2022-01-12,AF,Afghanistan,EMRO,58,158452,1,7374
2022-01-13,AF,Afghanistan,EMRO,59,158511,2,7376
2022-01-14,AF,Afghanistan,EMRO,91,158602,0,7376
2022-01-15,AF,Afghanistan,EMRO,37,158639,0,7376
2022-01-16,AF,Afghanistan,EMRO,39,158678,2,7378
2022-01-17,AF,Afghanistan,EMRO,59,158737,1,7379
2022-01-18,AF,Afghanistan,EMRO,89,158826,2,7381
2022-01-19,AF,Afghanistan,EMRO,148,158974,2,7383
2022-01-20,AF,Afghanistan,EMRO,96,159070,3,7386
2022-01-21,AF,Afghanistan,EMRO,233,159303,0,7386
2022-01-22,AF,Afghanistan,EMRO,13,159316,0,7386
2022-01-23,AF,Afghanistan,EMRO,232,159548,4,7390
2022-01-24,AF,Afghanistan,EMRO,134,159682,3,7393
2022-01-25,AF,Afghanistan,EMRO,214,159896,0,7393
2022-01-26,AF,Afghanistan,EMRO,356,160252,4,7397
2022-01-27,AF,Afghanistan,EMRO,456,160708,4,7401
2022-01-28,AF,Afghanistan,EMRO,301,161009,2,7403
2022-01-29,AF,Afghanistan,EMRO,49,161058,0,7403
2022-01-30,AF,Afghanistan,EMRO,608,161666,4,7407
2022-01-31,AF,Afghanistan,EMRO,474,162140,2,7409
2022-02-01,AF,Afghanistan,EMRO,610,162750,5,7414
2022-02-02,AF,Afghanistan,EMRO,970,163720,3,7417
2022-02-03,AF,Afghanistan,EMRO,470,164190,1,7418
2022-02-04,AF,Afghanistan,EMRO,537,164727,2,7420
2022-02-05,AF,Afghanistan,EMRO,631,165358,0,7420
2022-02-06,AF,Afghanistan,EMRO,354,165712,5,7425
2022-02-07,AF,Afghanistan,EMRO,479,166191,7,7432
2022-02-08,AF,Afghanistan,EMRO,733,166924,10,7442
2022-02-09,AF,Afghanistan,EMRO,815,167739,12,7454
2022-02-10,AF,Afghanistan,EMRO,811,168550,11,7465
2022-02-11,AF,Afghanistan,EMRO,898,169448,12,7477
2022-02-12,AF,Afghanistan,EMRO,490,169938,5,7482
2022-02-13,AF,Afghanistan,EMRO,214,170152,6,7488
2022-02-14,AF,Afghanistan,EMRO,452,170604,6,7494
2022-02-15,AF,Afghanistan,EMRO,472,171076,7,7501
2022-02-16,AF,Afghanistan,EMRO,346,171422,3,7504
2022-02-17,AF,Afghanistan,EMRO,97,171519,9,7513
2022-02-18,AF,Afghanistan,EMRO,154,171673,11,7524
2022-02-19,AF,Afghanistan,EMRO,197,171870,5,7529
2022-02-20,AF,Afghanistan,EMRO,60,171930,5,7534
2022-02-21,AF,Afghanistan,EMRO,276,172206,7,7541
2022-02-22,AF,Afghanistan,EMRO,235,172441,8,7549
2022-02-23,AF,Afghanistan,EMRO,460,172901,25,7574
2022-02-24,AF,Afghanistan,EMRO,23,172924,1,7575
2022-02-25,AF,Afghanistan,EMRO,123,173047,3,7578
2022-02-26,AF,Afghanistan,EMRO,69,173116,3,7581
2022-02-27,AF,Afghanistan,EMRO,64,173180,7,7588
2022-02-28,AF,Afghanistan,EMRO,215,173395,5,7593
2022-03-01,AF,Afghanistan,EMRO,264,173659,5,7598
2022-03-02,AF,Afghanistan,EMRO,220,173879,11,7609
2022-03-03,AF,Afghanistan,EMRO,194,174073,8,7617
2022-03-04,AF,Afghanistan,EMRO,141,174214,2,7619
2022-03-05,AF,Afghanistan,EMRO,55,174269,1,7620
2022-03-06,AF,Afghanistan,EMRO,78,174347,2,7622
2022-03-07,AF,Afghanistan,EMRO,235,174582,1,7623
2022-03-08,AF,Afghanistan,EMRO,418,175000,3,7626
2022-03-09,AF,Afghanistan,EMRO,353,175353,4,7630
2022-03-10,AF,Afghanistan,EMRO,172,175525,6,7636
2022-03-11,AF,Afghanistan,EMRO,347,175872,3,7639
2022-03-12,AF,Afghanistan,EMRO,88,175960,1,7640
2022-03-13,AF,Afghanistan,EMRO,102,176062,2,7642
2022-03-14,AF,Afghanistan,EMRO,139,176201,1,7643
2022-03-15,AF,Afghanistan,EMRO,208,176409,2,7645
2022-03-16,AF,Afghanistan,EMRO,162,176571,1,7646
2022-03-17,AF,Afghanistan,EMRO,172,176743,5,7651
2022-03-18,AF,Afghanistan,EMRO,175,176918,0,7651
2022-03-19,AF,Afghanistan,EMRO,91,177009,0,7651
2022-03-20,AF,Afghanistan,EMRO,30,177039,1,7652
2022-03-21,AF,Afghanistan,EMRO,77,177116,2,7654
2022-03-22,AF,Afghanistan,EMRO,75,177191,0,7654
2022-03-23,AF,Afghanistan,EMRO,64,177255,2,7656
2022-03-24,AF,Afghanistan,EMRO,66,177321,1,7657
2022-03-25,AF,Afghanistan,EMRO,70,177391,1,7658
2022-03-26,AF,Afghanistan,EMRO,44,177435,0,7658
2022-03-27,AF,Afghanistan,EMRO,39,177474,2,7660
2022-03-28,AF,Afghanistan,EMRO,70,177544,2,7662
2022-03-29,AF,Afghanistan,EMRO,58,177602,1,7663
2022-03-30,AF,Afghanistan,EMRO,61,177663,2,7665
2022-03-31,AF,Afghanistan,EMRO,31,177694,0,7665
2022-04-01,AF,Afghanistan,EMRO,53,177747,5,7670
2022-04-02,AF,Afghanistan,EMRO,24,177771,1,7671
2022-04-03,AF,Afghanistan,EMRO,34,177805,0,7671
2022-04-04,AF,Afghanistan,EMRO,22,177827,0,7671
2022-04-05,AF,Afghanistan,EMRO,70,177897,0,7671
2022-04-06,AF,Afghanistan,EMRO,35,177932,0,7671
2022-04-07,AF,Afghanistan,EMRO,85,178017,2,7673
2022-04-08,AF,Afghanistan,EMRO,44,178061,0,7673
2022-04-09,AF,Afghanistan,EMRO,29,178090,2,7675
2022-04-10,AF,Afghanistan,EMRO,51,178141,0,7675
2022-04-11,AF,Afghanistan,EMRO,0,178141,0,7675
2022-04-12,AF,Afghanistan,EMRO,50,178191,0,7675
2022-04-13,AF,Afghanistan,EMRO,104,178295,1,7676
2022-04-14,AF,Afghanistan,EMRO,37,178332,0,7676
2022-04-15,AF,Afghanistan,EMRO,20,178352,0,7676
2022-04-16,AF,Afghanistan,EMRO,21,178373,0,7676
2022-04-17,AF,Afghanistan,EMRO,14,178387,0,7676
2022-04-18,AF,Afghanistan,EMRO,31,178418,2,7678
2022-04-19,AF,Afghanistan,EMRO,95,178513,2,7680
2022-04-20,AF,Afghanistan,EMRO,3,178516,0,7680
2022-04-21,AF,Afghanistan,EMRO,39,178555,0,7680
2022-04-22,AF,Afghanistan,EMRO,56,178611,0,7680
2022-04-23,AF,Afghanistan,EMRO,25,178636,0,7680
2022-04-24,AF,Afghanistan,EMRO,12,178648,1,7681
2022-04-25,AF,Afghanistan,EMRO,41,178689,1,7682
2022-04-26,AF,Afghanistan,EMRO,56,178745,1,7683
2022-04-27,AF,Afghanistan,EMRO,24,178769,0,7683
2022-04-28,AF,Afghanistan,EMRO,0,178769,0,7683
2022-04-29,AF,Afghanistan,EMRO,81,178850,0,7683
2022-04-30,AF,Afghanistan,EMRO,23,178873,0,7683
2022-05-01,AF,Afghanistan,EMRO,6,178879,0,7683
2022-05-02,AF,Afghanistan,EMRO,20,178899,0,7683
2022-05-03,AF,Afghanistan,EMRO,2,178901,0,7683
2022-05-04,AF,Afghanistan,EMRO,0,178901,0,7683
2022-05-05,AF,Afghanistan,EMRO,4,178905,1,7684
2022-05-06,AF,Afghanistan,EMRO,0,178905,0,7684
2022-05-07,AF,Afghanistan,EMRO,14,178919,0,7684
2022-05-08,AF,Afghanistan,EMRO,4,178923,0,7684
2022-05-09,AF,Afghanistan,EMRO,58,178981,0,7684
2022-05-10,AF,Afghanistan,EMRO,29,179010,1,7685
2022-05-11,AF,Afghanistan,EMRO,56,179066,1,7686
2022-05-12,AF,Afghanistan,EMRO,65,179131,0,7686
2022-05-13,AF,Afghanistan,EMRO,38,179169,0,7686
2022-05-14,AF,Afghanistan,EMRO,51,179220,1,7687
2022-05-15,AF,Afghanistan,EMRO,23,179243,3,7690
2022-05-16,AF,Afghanistan,EMRO,24,179267,0,7690
2022-05-17,AF,Afghanistan,EMRO,54,179321,1,7691
2022-05-18,AF,Afghanistan,EMRO,95,179416,0,7691
2022-05-19,AF,Afghanistan,EMRO,31,179447,0,7691
2022-05-20,AF,Afghanistan,EMRO,150,179597,4,7695
2022-05-21,AF,Afghanistan,EMRO,72,179669,2,7697
2022-05-22,AF,Afghanistan,EMRO,5,179674,0,7697
2022-05-23,AF,Afghanistan,EMRO,42,179716,1,7698
2022-05-24,AF,Afghanistan,EMRO,55,179771,0,7698
2022-05-25,AF,Afghanistan,EMRO,64,179835,1,7699
2022-05-26,AF,Afghanistan,EMRO,73,179908,0,7699
2022-05-27,AF,Afghanistan,EMRO,116,180024,0,7699
2022-05-28,AF,Afghanistan,EMRO,68,180092,0,7699
2022-05-29,AF,Afghanistan,EMRO,31,180123,2,7701
2022-05-30,AF,Afghanistan,EMRO,53,180176,0,7701
2022-05-31,AF,Afghanistan,EMRO,87,180263,2,7703
2022-06-01,AF,Afghanistan,EMRO,84,180347,2,7705
2022-06-02,AF,Afghanistan,EMRO,72,180419,2,7707
2022-06-03,AF,Afghanistan,EMRO,0,180419,0,7707
